NO ./sprites/wall1.xpm
SO ./sprites/wall2.xpm
WE ./sprites/wall7.xpm
EA ./sprites/wall8.xpm

F 0,75,73
C 142,200,216

1111
10N1
1111
