111111111111111111111111111111111111
10000000001C0000100000000000C10C0001
1000000010000000100000010000C1001001
100000111111111110000001111111001001
100000000000000010000000000000001001
100000000000000010000000000001001001
1000000000100000100000000000010010P1
100000000010000010000000000001001001
100000000011111110000000000001001001
1E0000000000000000000000000001000001
111111111111111111111111111111111111
